X - przeszkoda
M - żyła
T - drzewo
  - wolna przestrzeń

X MTTMMXMXXM XMMMX TMX  MXT MT XMXX TXXTMMMTM    X
XX XTXT XMTTMMTTMX X TTXTT T TXX TMTM X XTTTT  MMX
 TM  TTTXTM   MM MM MTM  TMMTMX MXT XXTXMTTMMMM T 
 TXXMTTXXXTXM TM TT  TMTT  TXTM X MM TMTTMXXM MXM 
 XXTTX M XXMTMT MXTT X XXMXMTXXMMX XM XX TMMMX TMM
TXTXMMTXMTTXMXMTX T XMM TTMTTMXMTX  XMM X  X MMT T
T T TMMT TTT M  M XM X XTT X XM  TXXXTT MXM TX XT 
  MTXMTTMTXT  MTM  XMMMTX  M MMXMX XXX TX MTX  X X
XTMXTX TM TXX  MMMXX TXMXMM  MXXT M MM TMTTTMTX XT
XMTXTXXTX MTMMTXM T TMM TXM  T M  MTXXMMMM  M XMTT
X MXT   MTMX XMXXTX XXTXTTTMMMXMMMTMTT  MXTT MX TM
XX TTXTX TXTTT T MX XXTMX M M MTTMTMXMXT XTXTTTXTT
XXXTMT XTMXMMMX T XM X X T MM   X  MMMM TT  XMTTXT
XTXTTTMXMMTM XM TMM  XXXXXTMM M X XX XTTTTT XT MXM
     TXM   XM XTTMX TTXTTMT XXMTXT M TT MXX TXMMTX
TMMTMMX  TXM T MXT TX  MMMXM  MX  M XXT MTXXMMXXM 
TMXTXM XMMX XM TXTMMTMXTMTXTMMMMT  M  MMMTMTMMMXMT
TXXXMMM  T TT XMMMX XM M    X TXMTTT T TMMMMTM XM 
TXXTXMXTMMXTXMTM XM  TT   TT MXTXXTM T XXXXXX  TMT
XTMMT M X XMXMMTXM M TXXXTXX XXMXM  MMM  MMMMMXTMM
TMTXMMMX MTXX  XMT MMMMX T  TTT TXTXTTTXTMTM XTXMM
TMTT TX TXMT TM  TX  M  XM T XXMX TXMXT  MXX XMMTX
T  XMM T TTTTTMX XMXXXMXT T MMMX T X XM  MMMXM MXM
XMM  XX XTX XXXMM  XT XT T MMX MXTTTM  TTMXMX XMXX
X   X TXMX MM MMMMMXTT  TMTTXTTTMXXTTTXXXTM MMXX M
TMMMMTXMX T XTXXX TXMMTXXTM XMT XTXXXMTMXMXTXTXXMX
TXM TTMXT  XMMMXTT MTTTX  XMTTTMTX  TMTMM XMM X  T
XTMMXTTXT TXXMXXXXT XMXMTMTXMXXMM XT XTXT T X XTTM
MMXMXM M MXTTXX X XTXXMX XMX X  MMM  XXT TTTMTXMMM
XXMXMTTTMMT M TTT   TM M XXT M XTXXTX XXXXXTMTXTXM
XMTXT XXM MXXTTMTMT M    TM MTXT    TT XMT TTT XMX
  X MTXMTXTX XTTTXT M  XMMTTXMTX XMXXXMXXXXMTTM  X
 TTXX  T X XTTTTTMTM TMMXXTXMTTTM    M  TXMMXMTTXT
MTX X T T X X X TMXX MMMTTMMXXX XXT MX MX MXXMTMTM
XT   MXMTT X T MMMMTTX XXX XMTMMMMTX  MXXX X M MMT
X X XTMTTMT MTTTT   MTM XTTXMXXXTXMT  TT TMMTX MM 
MXMM XXMXXMMXXMM X  XMT  MMTM MM XT XXXMMTM TXXM M
MXMXTTX MX MXMX MXXXXM XXXMXT TXX MTT  T TTX X T M
 MMX TX  T M XMXXMTTM XX MTTX TXMT MMM XMM TMTXXMX
T  TTMTTMXTM MTXXXTMTTMTXXTMXT X  MT MTM TMTMMMMMT
 XXT  TXTT  TMXXTM TTT XXXX  MT TXXXM MMXTTMM   TM
T M   XT X    XXM TTXTM  MTXMMXTMMTTXTXXM TT XTTTM
XX  XTTTMMXMTTXM XXM XMTMX T TXMMX  TTXTTXM XXM TX
 X X MXXXT X XX MMTXTTMXXMTTMTX XX TM MXTXTTTTT  T
XTXXX  MMTM   MMMTT    TTT  MXM XM XT    M   XXXMX
T TTT   MXTTM XM  XTXXTTT XMMTTMXMM XXXT TXTM   TX
TMTX MX  TXM TMXXXTM MTMXMXMM MTT XXM MMXTXTMTXMMM
M TMT M M X  MXXTMT M TXTXXXTMXXMXXXX TXX  XMTX   
TTX TMT MMM TM  XM T MMMMMM  TMXM XX TXMTT X MXX M
T MTMX MXXTTXXMTXXXXXX MMTTT TMX TXMTXTXXXXMTT  MX
